{
    "map": [
        "UUUUUUUUUUUUUUUUUUUUUUUUUUUUUUUUUUUUUUUUUUUUUUUUUUUUUUUUUUUUUUUU",
        "LMMGMMMMMMMMMMMMMMMGMMMMMMGMMMMMMGMMMMMMGMMMMMMGMMMMMMGMMMMMMGMR",
        "LMGGGGGGGGGGGGGGGGGGGGGGGGGGGGGGGGGGGGGGGGGGGGGGGGGGGGGGGGGGGGMR",
        "LMGGGGGGGGGGGGGGGGGGGGGGGGGGGGGGGGGGGGGGGGGGGGGGGGGGGGGGGGGGGGMR",
        "LMGGGGGGGGGGGGGGGGGGGGGGGGGGGGGGGGGGGGGGGGGGGGGGGGGGGGGGGGGGGGMR",
        "LMGGGGGGGGGGGGGGGGGGGGGGGGGGGGGGGGGGGGGGGGGGGGGGGGGGGGGGGGGGGGMR",
        "LMGGGGGGGGGGGGGGGGGGGGGGGGGGGGGGGGGGGGGGGGGGGGGGGGGGGGGGGGGGGGGR",
        "LGGGGGGGGGGGGGGGGGGGGGGGGGGGGGGGGGGGGGGGGGGGGGGGGGGGGGGGGGGGGGGR",
        "LGGGGGGGGGGGGGGGGGGGGGGGGGGGGGGGGGGGGGGGGGGGGGGGGGGGGGGGGGGGGGGR",
        "LGGGGGGGGGGGGGGGGGGGGGGGGGGGGGGGGGGGGGGGGGGGGGGGGGGGGGGGGGGGGGGR",
        "LGGGOGGGOOGGGGGGGGGGGGGGGGGGGGGGGGGGGGGGGGGGGGGGGGGGGGGGGGGGGGGR",
        "LGGGGGGGOGGGGGGGGGGGGGGGGGGGGGGGGGGGGGGGGGGGGGGGGGGOGGGGGGGGGGGR",
        "LGGGGGGGOGGGGGGGGGGGGGGGGGGGGGGGGGGGGOGOGGGGGGGGGGGOGGGGGOGGGGGR",
        "LGGGGGGGGGGGGGGGGGGGGGGGGGGGGGGGGGGGGGGOOGGGGGGGGGGGOOOGOGGGGGGR",
        "LGGGOGGGGOGGGGGGGGGGGGGGGGGGGGGGGGGGGOOOGGGGGGGGGGGOGGOOGOGGGGGR",
        "LGGGGGGOOOGGGGGGGGGGGGGGGGGGGGGGGGOOGOOGGGGGGGGGGGGGGOGOGGGGGGGR",
        "LGGGGGGGGGGGGGGGGGGGGGGGGGGGGGGGGGGGOGGOGGGGGGGGGGGGOGGOGGGGGGGR",
        "LGGGGGGGGGGGGGGGGGGGGGGGGGGGGGGGGGGOGGOOGGGGGGGGGGGGGGGOOOGGGGGR",
        "LGGGGGGGGGGGGGGGGGGGGGGGGGGGOGGGGGGGGGOOOGGGGGGGGGGGGGGGGGGGGGGR",
        "LGGGGGGGGGGGGGGGGGGGGGGGOOOOGGGGGGGGGGGGGGGGGGGGGGGGGGGGGGGGGGGR",
        "LGGGGGGGGGGGGGGGGGGGGGGGOOOGGGGGGGGGGGGGGGGGGGGGGGGGGGGGGGGGGGGR",
        "LGGGGGGGGGGGGGGGGGGGGGGGGGGGOOGGGGGGGGGGGGGGGGGGGGGGGGGGGGGGGGGR",
        "LGGGGGGGGGGGGGGGGGGGGGGGOGOOGOOGGGGGGGGGGGGGGGGGGGGGGGGGGGGGGGGR",
        "LGGGGGGGGGGGGGGGGGGGGGGGOGGGOGGGGGGGGGGGGGGGGGGGGGGGGGGGGGGGGGGR",
        "LGGGGGGGGGGGGGGGGGGGGGGGOOGGGGGGGGGGGGGGGGGGGGGGGGGGGGGGGGGGGGGR",
        "LGGGGGGGGGGGGGGGGGGGGGGGGGGGGGGGGGGGGGGGGGGGGGGGGGGGGGGGGGGGGGGR",
        "LGGGGGGGGGGGGGGGGGGGGGGGGGGGGGGGGGGGGGGGGGGGGGGGGGGGGGGGGGGGGGGR",
        "LGGGGGGGGGGGGGGGGGGGGGGGGGGGGGGGGGGGGGGGGGGGGGGGGGGGGGGGGGGGGGGR",
        "LGGGGGGGGGGGGGGGGGGGGGGGGGGGGGGGGGGGGGGGGGGGGGGGGGGGGGGGGGGGGGGR",
        "LGGGGGGGGGGGGGGGGGGGGGGGGGGGGGGGGGGGGGGGGGGGGGGGGGGGGGGGGGGGGGGR",
        "LGGGGGGGGGGGGGGGGGGGGGGGGGGGGGGGGGGGGGGGGGGGGGGGGGGGGGGGGGGGGGGR",
        "LGGGGGGGGGGGGGGGGGGGGGGGGGGGGGGGGGGGGGGGGGGGGGGGGGGGGGGGGGGGGGGR",
        "LGGGGGGGGGGGGGGGGGGGGGGGGGGGGGGGGGGGGGGGGGGGGGGGGGGOGOGGGGGGGGGR",
        "LGGGGGGGGGGGGGGGGGGGGGGGGGGGGGGGGGGGGGGGGGGGGGGGGGGGGGOGGGGGGGGR",
        "LGGGGGGGGGGGGGGGGGGGGGGGGGGGGGGGGGGGGGGGGGGGGGGGGGGGGGGGGGGGGGGR",
        "LGGGGGGGGGGGGGGGGGGGGGGGGGGGGGGGGGGGGGGGGGGGGGGGGGGGGGGGGGGGGGGR",
        "LGGGGGGGGGGGGGGGGGGGGGGGGGGGGGGGGGGGGGGGGGGGGGGGGGGGGGGGGGGGGGGR",
        "LGGGGGGGGGGGGGGGGGGGGGGGGGGGGGGGGGGGGGGGGGGGGGGGGGOGGGGGGGGGGGGR",
        "LGGGGGGGGGGGGGGGGGGGGGGGGGGGGGGGGGGGGGGGGGGGGGGGGOGGGGGOGGGGGGGR",
        "LGGGGGGGGGGGGGGGGGGGGGGGGGGGGGGGGGGGGGGGGGGGGGGGGGGGGGGGGGGGGGGR",
        "LGGGGGGGGGGGGGGGGGGGGGGGGGGGGGGGGGGGGGGGGGGGGGGGGGGGGGGGGGGGGGGR",
        "LGGGGGGGGGGGGGGGGGGGGGGGGGGGGGGGGGGGGGGGGGGGGGGGGGGGGGGGGGGGGGGR",
        "LGGGGGGGGGGGGGGGGGGGGGGGGGGGGGGGGGGGGGGGGGGGGGGGGGGGGGGGGGGGGGGR",
        "LGGGGGGGGGGGGGGGGGGGGGGGGGGGGGGGGGGGGGGGGGGGGGGGGGGGGGGGGGGGGGGR",
        "LGGGGGGGGGGGGGGGGGGGGGGGGGGGGGGGGGGGGGGGGGGGGGGGGGGGGGGGGGGGGGGR",
        "LGGGGGGGGGGGGGGGGGGGGGGGGGGGGGGGGGGGGGGGGGGGGGGGGGGGGGGGGGGGGGGR",
        "LGGGOOGGOGGGGGGGGGGGGGGGGGGGGGGGGGGGGGGGGGGGGGGGGGGGGGGGGGGGGGGR",
        "LGGGOOGGOGGGGGGGGGGGGGGGGGGGGGGGGGGGGGGGGGGGGGGGGGGGGGGGGGGGGGGR",
        "LGGGOGGGOOGGGGGGGGGGGGGGGGGGGGGGGGGGGGGGGGGGGGGGGGGGGGGGGGGGGGGR",
        "LGGGGGGOGGGGGGGGGGGGGGGGGGGGGGGGGGGGGGGGGGGGGGGGGGGGGGGGGGGGGGGR",
        "LGGGOGGGGGGGGGGGGGGGGGGGGGGGGGGGGGGGGGGGGGGGGGGGGGGGGGGGGGGGGGGR",
        "LGGGGGOOGOGGGGGGGGGGGGGGGGGGGGGGGGGGGGGGGGGGGGGGGGGGGGGGGGGGGGGR",
        "LGGGOOGGGGGGGGGGGGGGGGGGGGGGGGGGGGGGGGGGGGGGGGGGGGGGGGGGGGGGGGGR",
        "LGGGGGGGGGGGGGGGGGGGGGGGGGGGGGGGGGGGGGGGGGGGGGGGGGGGGGGGGGGGGGGR",
        "LGGGGGGGGGGGGGGGGGGGGGGGGGGGGGGGGGGGGGGGGGGGGGGGGGGGGGGGGGGGGGGR",
        "LGGGGGGGGGGGGGGGGGGGGGGGGGGGGGGGGGGGGGGGGGGGGGGGGGGGGGGGGGGGGGGR",
        "LGGGGGGGGGGGGGGGGGGGGGGGGGGGGGGGGGGGGGGGGGGGGGGGGGGGGGGGGGGGGGGR",
        "LGGGGGGGGGGGGGGGGGGGGGGGGGGGGGGGGGGGGGGGGGGGGGGGGGGGGGGGGGGGGGGR",
        "LGGGGGGGGGGGGGGGGGGGGGGGGGGGGGGGGGGGGGGGGGGGGGGGGGGGGGGGGGGGGGGR",
        "LGGGGGGGGGGGGGGGGGGGGGGGGGGGGGGGGGGGGGGGGGGGGGGGGGGGGGGGGGGGGGGR",
        "LGGGGGGGGGGGGGGGGGGGGGGGGGGGGGGGGGGGGGGGGGGGGGGGGGGGGGGGGGGGGGGR",
        "LGGGGGGGGGGGGGGGGGGGGGGGGGGGGGGGGGGGGGGGGGGGGGGGGGGGGGGGGGGGGGGR",
        "LGGGGGGGGGGGGGGGGGGGGGGGGGGGGGGGGGGGGGGGGGGGGGGGGGGGGGGGGGGGGGGR",
        "DDDDDDDDDDDDDDDDDDDDDDDDDDDDDDDDDDDDDDDDDDDDDDDDDDDDDDDDDDDDDDDD"
    ]
}