{
    "map": [
        "UUUUUUUUUUUUUUUUUUUUUUUUUUUUUUUUUUUUUUUUUUUUUUUUUUUUUUUUUUUUUUUU",
        "LMWMMMMWMWWMWWWWMWMWMWMWMWMWMWMWMWMWMWMWMWMWMWMWMWMWMWMWMWMWMWMR",
        "LWMWMWMWMWMWMWMWMWMWMWMWWWWMMWMWMWMWMWMWWMWMGMGMWMWMGMWMWMWMWMWR",
        "LMWMWMWMWMWMWMWMWMWMWMWMWMWMWMWMWMWMWMWMWMWMGGGGMWMGGMWMWMWMWWMR",
        "LMWMWWMWMWMWMWMWMWMWMWMWMWMWMWMGMWMGMWMWMWMGMGMGMWMGMWMWMWMWMWMR",
        "LWMWMWMWMWMWMWMWWMWMWMWMWMWMGMGGMWMGMWMWMWMGMGMGMWMGMWMWMWMWMWMR",
        "LWMWMWMWMWMWMWMWMWMWMWMWMWMGGGGMGMGGMWMWMWMGGMGGMWMGGMGMGMWMWMWR",
        "LMWMWMWMGMGMGMGMGMGMGMGMGMGMGMGMGMGMGMGMGMGMGMGMGMGMGMGMGMWMWMWR",
        "LMWMWMWMGGGGGGGGGGGGGGGGGGGGGGGGGGGGGGGGGGGGGGGGGGGGGGGGGMWMWMWR",
        "LMWMWMWMGGGGGGGGGGGGGGGGGGGGGGGGGGGGGGGGGGGGGGGGGGGGGGGGGMWMWMWR",
        "LMWMWMWMGGGGGGGGGGGGGGGGGGGGGGGGGGGGGGGGGGGGGGGGGGGGGGGGGMWMWMWR",
        "LMWMWMWMGGGGGGGGGGGGGGGGGGGGGGGGGGGGGGGGGGGGGGGGGGGGGGGGGMWMWMWR",
        "LMWMWMWMGGGGGGGGGGGGGGGGGGGGGGGGGGGGGGGGGGGGGGGGGGGGGGGGGMWMWMWR",
        "LMWMWMWMGGGGGGGGGGGGGGGGGGGGGGGGGGGGGGGGGGGGGGGGGGGGGGGGGMWMWMWR",
        "LMWMWMWMGGGGGGGGGGGGGGGGGGGGGGGGGGGGGGGGGGGGGGGGGGGGGGGGGMWMWMWR",
        "LMWMWMWMGGGGGGGGGGGGGGGGGGGGGGGGGGGGGGGGGGGGGGGGGGGGGGGGGMWMWMWR",
        "LMWMWMWMGGGGGGGGGGGGGGGGGGGGGGGGGGGGGGGGGGGGGGGGGGGGGGGGGMWMWMWR",
        "LMWMWMWMGGGGGGGGGGGGGGGGGGGGGGGGGGGGGGGGGGGGGGGGGGGGGGGGGMWMWMWR",
        "LMWMWMWMGGGGGGGGGGGGGGGGGGGGGGGGGGGGGGGGGGGGGGGGGGGGGGGGGMWMWMWR",
        "LMWMWMWMGGGGGGGGGGGGGGGGGGGGGGGGGGGGGGGGGGGGGGGGGGGGGGGGGMWMWMWR",
        "LMWMWMWMGGGGGGGGGGGGGGGGGGGGGGGGGGGGGGGGGGGGGGGGGGGGGGGGGMWMWMWR",
        "LMWMWMWMGGGGGGGGGGGGGGGGGGGGGGGGGGGGGGGGGGGGGGGGGGGGGGGGGMWMWMWR",
        "LMWMWMWMGGGGGGGGGGGGGGGGGGGGGGGGGGGGGGGGGGGGGGGGGGGGGGGGGMWMWMWR",
        "LMWMWMWMGGGGGGGGGGGGGGGGGGGGGGGGGGGGGGGGGGGGGGGGGGGGGGGGGMWMWMWR",
        "LMWMWMWMGGGGGGGGGGGGGGGGGGGGGGGGGGGGGGGGGGGGGGGGGGGGGGGGGMWMWMWR",
        "LMWMWMWMGGGGGGGGGGGGGGGGGGGGGGGGGGGGGGGGGGGGGGGGGGGGGGGGGMWMWMWR",
        "LMWMWMWMGGGGGGGGGGGGGGGGGGGGGGGGGGGGGGGGGGGGGGGGGGGGGGGGGMWMWMWR",
        "LMWMWMWMGGGGGGGGGGGGGGGGGGGGGGGGGGGGGGGGGGGGGGGGGGGGGGGGGMWMWMWR",
        "LMWMWMWMGGGGGGGGGGGGGGGGGGGGGGGGGGGGGGGGGGGGGGGGGGGGGGGGGMWMWMWR",
        "LMWMWMWMGGGGGGGGGGGGGGGGGGGGGGGGGGGGGGGGGGGGGGGGGGGGGGGGGMWMWMWR",
        "LMWMWMWMGGGGGGGGGGGGGGGGGGGGGGGGGGGGGGGGGGGGGGGGGGGGGGGGGMWMWMWR",
        "LMWMWMWMGGGGGGGGGGGGGGGGGGGGGGGGGGGGGGGGGGGGGGGGGGGGGGGGGMWMWMWR",
        "LMWMWMWMGGGGGGGGGGGGGGGGGGGGGGGGGGGGGGGGGGGGGGGGGGGGGGGGGMWMWMWR",
        "LMWMWMWMGGGGGGGGGGGGGGGGGGGGGGGGGGGGGGGGGGGGGGGGGGGGGGGGGMWMWMWR",
        "LMWMWMWMGGGGGGGGGGGGGGGGGGGGGGGGGGGGGGGGGGGGGGGGGGGGGGGGGMWMWMWR",
        "LMWMWMWMGGGGGGGGGGGGGGGGGGGGGGGGGGGGGGGGGGGGGGGGGGGGGGGGGMWMWMWR",
        "LMWMWMWMGGGGGGGGGGGGGGGGGGGGGGGGGGGGGGGGGGGGGGGGGGGGGGGGGMWMWMWR",
        "LMWMWMWMGGGGGGGGGGGGGGGGGGGGGGGGGGGGGGGGGGGGGGGGGGGGGGGGGMWMWMWR",
        "LMWMWMWMGGGGGGGGGGGGGGGGGGGGGGGGGGGGGGGGGGGGGGGGGGGGGGGGGMWMWMWR",
        "LMWMWMWMGGGGGGGGGGGGGGGGGGGGGGGGGGGGGGGGGGGGGGGGGGGGGGGGGMWMWMWR",
        "LMWMWMWMGGGGGGGGGGGGGGGGGGGGGGGGGGGGGGGGGGGGGGGGGGGGGGGGGMWMWMWR",
        "LMWMWMWMGGGGGGGGGGGGGGGGGGOOGOOOOGOGGGGGGGGGGGGGGGGGGGGGGMWMWMWR",
        "LMWMWMWMGGGGGGGGGGGGGGGGGGGOGGGGGOGGGGGGGGGGGGGGGGGGGGGGGMWMWMWR",
        "LMWMWMWMGGGGGGGGGGGGGGGGGGOGGOGOOOOOGGGGGGGGGGGGGGGGGGGGGMWMWMWR",
        "LMWMWMWMGGGGGGGGGGGGGGGGGGGGOGGGGGOGOGGOGGGGGGGGGGGGGGGGGMWMWMWR",
        "LMWMWMWMGGGGGGGGGGGGGGGGGGGGGGGOGGOGGOGGGGGGGGGGGGGGGGGGGMWMWMWR",
        "LMWMWMWMGGGGGGGGGGGGGGGGGGGOGOOOGOOGGGGOGGGGGGGGGGGGGGGGGMWMWMWR",
        "LMWMWMWMGGGGGGGGGGGGGGGGGGGGGGOOGGGGOOGGGGGGGGGGGGGGGGGGGMWMWMWR",
        "LMWMWMWMGGGGGGGGGGGGGGGGGGGOGGOOGOOOGOGGGGGGGGGGGGGGGGGGGMWMWMWR",
        "LMWMWMWMGGGGGGGGGGGGGGGGGGGOGGGOGOOOOOGGGGGGGGGGGGGGGGGGGMWMWMWR",
        "LMWMWMWMGGGGGGGGGGGGGGGGGGGGGGGOGOGGGGGOGGGGGGGGGGGGGGGGGMWMWMWR",
        "LMWMWMWMGGGGGGGGGGGGGGGGGGGGGGGGOOGGGOGGGGGGGGGGGGGGGGGGGMWMWMWR",
        "LMWMWMWMGGGGGGGGGGGGGGGGGGGGGGGGGGGGGGGGGGGGGGGGGGGGGGGGGMWMWMWR",
        "LMWMWMWMGGGGGGGGGGGGGGGGGGGGGGGGGGGGGGGGGGGGGGGGGGGGGGGGGMWMWMWR",
        "LMWMWMWMGGGGGGGGGGGGGGGGGGGGGGGGGGGGGGGGGGGGGGGGGGGGGGGGGMWMWMWR",
        "LMWMWMWMGGGGGGGGGGGGGGGGGGGGGGGGGGGGGGGGGGGGGGGGGGGGGGGGGMWMWMWR",
        "LMWMWMWMGMGMGMGMGMGMGMGMGMGMGMGMGMGMGMGMGMGMGMGMGMGMGMGMGMWMWMWR",
        "LMWMWMWMGMGMGMGMGMGMGMGMGMGMGMGMGMGMGMGMGMGMGMGMGMGMGMGMGMWMWMWR",
        "LMWMWMWMGMGMGMGMGMGMGMGMGMGMGMGMGMGMGMGMGMGMGMGMGMGMGMGMGMWMWMWR",
        "LMWMWMWMGMGMGMGMGMGMGMGMGMGMGMGMGMGMGMGMGMGMGMGMGMGMGMGMGMWMWMWR",
        "LMWMWMWMGMGMGMGMGMGMGMGMGMGMGMGMGMGMGMGMGMGMGMGMGMGMGMGMGMWMWMWR",
        "LMWMWMWMGMGMGMGMGMGMGMGMGMGMGMGMGMGMGMGMGMGMGMGMGMGMGMGMGMWMWMWR",
        "LMWMWMWMGMGMGMGMGMGMGMGMGMGMGMGMGMGMGMGMGMGMGMGMGMGMGMGMGMWMWMWR",
        "DDDDDDDDDDDDDDDDDDDDDDDDDDDDDDDDDDDDDDDDDDDDDDDDDDDDDDDDDDDDDDDD"
    ]
}