{
    "map": [
        "UUUUUUUUUUUUUUUUUUUUUUUUUUUUUUUUUUUUUUUUUUUUUUUUUUUUUUUUUUUUUUUU",
        "LMMGMMMMMMMMMMMMMMMMMMMMMMMMMMMMMMMMMMMMMMMMMMMMMMMMMMMMMMMMMMMR",
        "LMGGGGGGGGGGGGGGGGGGGGGGGGGGGGGGGGGGGGGGGGGGGGGGGGGGGGGGGGGGGGGR",
        "LGGGGGGGGGGGGGGGGGGGGGGGGGGGGGGGGGGGGGGGGGGGGGGGGGGGGGGGGGGGGGGR",
        "LGGGGGGGGGGGGGGGGGGGGGGGGGGGGGGGGGGGGGGGGGGGGGGGGGGGGGGGGGGGGGGR",
        "LGGGGGGGGGGGGGGGGGGGGGGGGGGGGGGGGGGGGGGGGGGGGGGGGGGGGGGGGGGGGGGR",
        "LGGGGGGGGGGGGGGGGGGGGGGGGGGGGGGGGGGGGGGGGGGGGGGGGGGGGGGGGGGGGGGR",
        "LGGGGGGGGGGGGGGGGGGGGGGGGGGGGGGGGGGGGGGGGGGGGGGGGGGGGGGGGGGGGGGR",
        "LGGGGGGGGGGGGGGGGGGGGGGGGGGGGGGGGGGGGGGGGGGGGGGGGGGGGGGGGGGGGGGR",
        "LGGGGGGGGGGGGGGGGGGGGGGGGGGGGGGGGGGGGGGGGGGGGGGGGGGGGGGGGGGGGGGR",
        "LGGGGGGGGGGGGGGGGGGGGGGGGGGGGGGGGGGGGGGGGGGGGGGGGOGGGGGGGGGGGGGR",
        "LGGGGGGGGGGGGGGGGGGGGGGGGGGGGGGGGGGGGGGGGGGOGGGGGGGGGGGGGGGGGGGR",
        "LGGGGGGGGGGGGGGGGGGGGGGGGGGGGGGGGGGGGGGGGGGGOGGGGGGGGGGGGGGGGGGR",
        "LGGGGGGGGGGGGGGGGGGGGGGGGGGGGGGGGGGGGGGGGGGOGGGGOGGGGGGGGGGGGGGR",
        "LGGGGGGGGGGGGGGGGGGGGGGGGGGGGGGGGGGGGGGGGGGGGGGOGGGGGGGGGGGGGGGR",
        "LGGGGGGGGGGGGGGGGGGGGGGGGGGGGGGGGGGGGGGGGGGGGOGGGGGGGGGGGGGGGGGR",
        "LGGGGGGGGGGGGGGGGGGGGGGGGGGGGGGGGGGGGGGGGGGGGGOGGGGGGGGGGGGGGGGR",
        "LGGGGGGGGGGGGGGGGGGGGGGGGGGGGGGGGGGGGGGGGGGGGGGGGGGGGGGGGGGGGGGR",
        "LGGGGGGGGGGGGGGGGGGGGGGGGGGGGGGGGGGGGGGGGGGGGGGGGGGGGGGGGGGGGGGR",
        "LGGGGGGGGGGGGGGGGGGGGGGGGGGGGGGGGGGGGGGGGGGGGGGGGGGGGGGGGGGGGGGR",
        "LGGGGGGGGGGGGGGGGGGGGGGGGGGGGGGGGGGGGGGGGGGGGGGGGGGGGGGGGGGGGGGR",
        "LGGGGGGGGGGGGGGGGGOGOGGOGGGGGGGGGGGGGGGGGGGGGGGGGGGGGGGGGGGGGGGR",
        "LGGGGGGGGGGGGGGGGGOGOGOGGGGGGGGGGGGGGGGGGGGGGGGGGGGGGGGGGGGGGGGR",
        "LGGGGGGGGGGGGGGGGOOGGGGGGGGGGGGGGGGGGGGGGGGGGGGGGGGGGGGGGGGGGGGR",
        "LGGGGGGGGGGGGGGGGOGOOGGGGGGGGGGGGGGGGGGGGGGGGGGGGGGGGGGGGGGGGGGR",
        "LGGGGGGGGGGGGGGGGGGGOOGGGGGGGGGGGGGGGGGGGGGGGGGGGGGGGGGOGGGGOGGR",
        "LGGGGGGGGGGGGGGGGGGGGOOOGGGGGGGGGGGGGGGGGGGGGGGGGGGGGGGGGOOGGGGR",
        "LGGGGGGGGGGGGGGGGGGGGGGGGGGGGGGGGGGGGGGGGGGGGGGGGGGGGGGGGOGGGOGR",
        "LGGGGGGGGGGGGGGGGGGGGGGGGGGGGGGGGGGGGGGGGGGGGGGGGGGGGGGOGGGGOGGR",
        "LGGGGGGGGGGGGGGGGGGGGGGGGGGGGGGGGGGGGGGGGGGGGGGGGGGGGGGOGOOGOGGR",
        "LGGGGGGGGGGGGGGGGGGGGGGGGGGGGGGGGGGGGGGGGGGGGGGGGGGGGGGGGOOGGGGR",
        "LGGGGGGGGGGGGGGGGGGGGGGGGGGGGGGGGGGGGGGGGGGGGGGGGGGGGGGGGGGGOGGR",
        "LGGGGGGGGGGGGGGGGGGGGGGGGGGGGGGGGGGGGGGGGGGGGGGGGGGGGGGGGGGGGGGR",
        "LGGGGGGGGGGGGGGGGGGGOGGGGGGGGGGGGGGGGGGGGGGGGGGGGGGGGGGGGGGGGGGR",
        "LGGGGGGGGGGOGGGGGGGGGGGOOOGGGGGGGGGGGGGGGGGGGGGGGGGGGGGGGGGGGGGR",
        "LGGGGGGOGGGGOGGGGGGGGGOGGGGGGGGGGGGGGGGGGGGGGGGGGGGGGGGGGGGGGGGR",
        "LGGGGGGOGGOOGGGGGGGGGGGGGOGGGGGGGGGGGGGGGGGGGGGGGGGGGGGGGGGGGGGR",
        "LGGGGGOGOGOGOGGGGGGGGGGGOGOGGGGGGGGGGGGGGGGGGGGGGGGGGGGGGGGGGGGR",
        "LGGGGGGOGGGGOGGGGGGGGOGGGGGGGGGGGGGGGGGGGGGGGGGGGGGGGGGGGGGGGGGR",
        "LGGGGGOOOGGGGGGGGGGGGGOGGGOGGGGGGGGGGGGGGGGGGGGGGGGGGGGGGGGGGGGR",
        "LGGGGGGOOGOGGGGGGGGGGGGGGGGGGGGGGGGGGGGGGGGGGGGGGGGGGGGGGGGGGGGR",
        "LGGGGGGGGGGGGGGGGGGGGGGGGGGGGGGGGGGGGGGGGGGGGGGGGGGGGGGGGGGGGGGR",
        "LGGGGGGGGGGGGGGGGGGGGGGGGGGGGGGGGGGGGGGGGGGGGGGGGGGGGGGGGGGGGGGR",
        "LGGGGGGGGGGGGGGGGGGGGGGGGGGGGGGGGGGGGGGGGGGGGGGGGGGGGGGGGGGGGGGR",
        "LGGGGGGGGGGGGGGGGGGGGGGGGGGGGGGGGGGGGGGGGGGGGGGGGGGGGGGGGGGGGGGR",
        "LGGGGGGGGGGGGGGGGGGGGGGGGGGGGGGGGGGGGGGGGGGGGGGGGGGGGGGGGGGGGGGR",
        "LGGGGGGGGGGGGGGGGGGGGGGGGGGGGGGGGGGGGGGGGGGGGGGGGGGGGGGGGGGGGGGR",
        "LGGGGGGGGGGGGGGGGGGGGGGGGGGGGGGGGGGGGGGGGGGGGGGGGGGGGGGGGGGGGGGR",
        "LGGGGGGGGGGGGGGGGGGGGGGGGGGGGOOOGGGGGGGGGGGGGGGGGGGGGGGGGGGGGGGR",
        "LGGGGGGGGGGGGGGGGGGGGGGGGGGOOGGOGGGGGGGGGGGGGGGGGGGGGGGGGGGGGGGR",
        "LGGGGGGGGGGGGGGGGGGGGGGGGGOGGGGGOGGGGGGGGGGGGGGGGGGGGGGGGGGGGGGR",
        "LGGGGGGGGGGGGGGGGGGGGGGGGGGOOGGGGGGGGGGGGGGGGGGGGGGGGGGGGGGGGGGR",
        "LGGGGGGGGGGGGGGGGGGGGGGGGGGGOOOOOGGGGGGGGGGGGGGGGGGGGGGGGGGGGGGR",
        "LGGGGGGGGGGGGGGGGGGGGGGGGGGOGOOOOGGGGGGGGGGGGGGGGGGGGGGGGGGGGGGR",
        "LGGGGGGGGGGGGGGGGGGGGGGGGGGOGOGGGGGGGGGGGGGGGGGGGGGGGGGGGGGGGGGR",
        "LGGGGGGGGGGGGGGGGGGGGGGGGGGGGGGGGGGGGGGGGGGGGGGGGGGGGGGGGGGGGGGR",
        "LGGGGGGGGGGGGGGGGGGGGGGGGGGGGGGGGGGGGGGGGGGGGGGGGGGGGGGGGGGGGGGR",
        "LGGGGGGGGGGGGGGGGGGGGGGGGGGGGGGGGGGGGGGGGGGGGGGGGGGGGGGGGGGGGGGR",
        "LGGGGGGGGGGGGGGGGGGGGGGGGGGGGGGGGGGGGGGGGGGGGGGGGGGGGGGGGGGGGGGR",
        "LGGGGGGGGGGGGGGGGGGGGGGGGGGGGGGGGGGGGGGGGGGGGGGGGGGGGGGGGGGGGGGR",
        "LGGGGGGGGGGGGGGGGGGGGGGGGGGGGGGGGGGGGGGGGGGGGGGGGGGGGGGGGGGGGGGR",
        "LGGGGGGGGGGGGGGGGGGGGGGGGGGGGGGGGGGGGGGGGGGGGGGGGGGGGGGGGGGGGGGR",
        "LGGGGGGGGGGGGGGGGGGGGGGGGGGGGGGGGGGGGGGGGGGGGGGGGGGGGGGGGGGGGGGR",
        "DDDDDDDDDDDDDDDDDDDDDDDDDDDDDDDDDDDDDDDDDDDDDDDDDDDDDDDDDDDDDDDD"
    ]
}