{
    "map": [
        "UUUUUUUUUUUUUUUUUUUUUUUUUUUUUUUUUUUUUUUUUUUUUUUUUUUUUUUUUUUUUUUU",
        "LMMGMMMMMMMMMMMMMMMMMMMMMMMMMMMMMMMMMMMMMMMMMMMMMMMMMMMMMMMMMMMR",
        "LMGGGGGGGGGGGGGGGGGGGGGGGGGGGGGGGGGGGGGGGGGGGGGGGGGGGGGGGGGGGGMR",
        "LMGGGGGGGGGGGGGGGGGGGGGGGGGGGGGGGGGGGGGGGGGGGGGGGGGGGGGGGGGGGGMR",
        "LMGGGGGGGGGGGGGGGGGGGGGGGGGGGGGGGGGGGGGGGGGGGGGGGGGGGGGGGGGGGGMR",
        "LMGGGGGGGGGGGGGGGGGGGGGGGGGGGGGGGGGGGGGGGGGGGGGGGGGGGGGGGGGGGGMR",
        "LMGGGGGGGGGGGGGGGGGGGGGGGGGGGGGGGGOGOGOGGGGGGGGGGGGGGGGGGGGGGGMR",
        "LMGGGGGGGGGGGGGGGGGGGGGGGGGGGGGGGGGOGGGGGGGGGGGGGGGGGGGGGGGGGGMR",
        "LMGGGGGGGGGGGGGGGGGGGGGGGGGGGGGGGGGGGOOGOGGGGGGGGGGGGGGGGGGGGGMR",
        "LMGGGGGGGGGGGGGGGGGGGGGGGGGGGGGGGGGGGGGGOGGGGGGGGGGGGGGGGGGGGGMR",
        "LMGGGGGGGGGGGGGGGGGGGGGGGGGGGGGGGGOGGGGGOGGGGGGGGGGGGGGGGGGGGGMR",
        "LMGGGGGGGGGGGGGGGGGGGGGGGGGGGGGGGGOGGGGGGGGGGGGGGGGGGGGGGGGGGGMR",
        "LMGGGGGGGGGGGGGGGGGGGGGGGGGGGGGGGGOGGGGGGGGGGGGGGGGGGGGGGGGGGGMR",
        "LMGGGGGGGGGGGGGGGGGGGGGGGGGGGGGGGGGGGGGGGGGGGGGGGGGGGGGGGGGGGGMR",
        "LMGGGGGGGGGGGGGGGGGGGGGGGGGGGGGGGGGGGGGGGGGGGGGGGGGGGGGGGGGGGGMR",
        "LMGGGGGGGGGGGGGGGGGGGGGGGGGGGGGGGGGGGGGGGGGGGGGGGGGGGGGGGGGGGGMR",
        "LMGGGGGGGGGGGGGGGGGGGGGGGGGGGGGGGGGGGGGGGGGGGGGGGGGGGGGGGGGGGGMR",
        "LMGGGGGGGGGGGGGGGGGGGGGGGGGGGGGGGGGGGGGGGGGGGGGGGGGGGGGGGGGGOGGR",
        "LGGGGGGGGGGGGGGGGGGGGGGGGGGGGGGGGGGGGGGGGGGGGGGGGGGGGGGGGGGGGGGR",
        "LGGGGGGGGGGGGGGGGGGGGGGGGGGGGGGGGGGGGGGGGGGGGGGGGGGGGGGGGGGGOGGR",
        "LGGGGGGGGGGGGGGGGGGGGGGGGGGGGGGGGGGGGGGGGGGGGGGGGGGGGGGGGGGOOGGR",
        "LGGGGGGGGGGGGGGGGGGGGGGGGGGGGGGGGGGGGGGGGGGGGGGGGGGGGGGGGGGGOOGR",
        "LGGGGGGGGGGGGGGGGGGGGGGGGGGGGGGGGGGGGGGGGGGGGGGGGGGGGGGGGGGOGGGR",
        "LGGGGGGGGGGGGGGGGGGGGGGGGGGGGGGGGGGGGGGGGGGGGGGGGGGGGGGGGGGGGGOR",
        "LGGGGGGGGGGGGGGGGGGGGGGGGGGGGGGGGGGGGGGGGGGGGGGGGGGGGGGGGGGGGGGR",
        "LGGGGGGGGGGGGGGGGGGGGGGGGGGGGGGGGGGGGGGGGGGGGGGGGGGGGGOGGOOGGGGR",
        "LGGGGGGGGGGGGGGGGGGGGGGGGGGGGGGGGGGGGGGGGGGGGGGGGGGGGGGOGGOGGGGR",
        "LGGGGGGGGGGGGGGGGGGGGGGGGGGGGGGGGGGGGGGGGGGGGGGGGGGGGOGGGOOGGGGR",
        "LGGGGGGGGGGGGGGGGGGGGGGGGGGGGGGGGGGGGGGGGGGGGGGGGGGGGGOGGGGGGGGR",
        "LGGGGGGGGGGGGGGGGGGGGGGGGGGGGGGGGGGGGGGGGGGGGGGGGGGGGGGGGOGGGGGR",
        "LGGGGGGGGGGGOGGGGGOGGGGGGGGGGGGGGGGGGGGGGGGGGGGGGGGGOGOOOGGGGGGR",
        "LGGGGGGGGGGGGGGOOGGGGGGGGGGGGGGGGGGGGGGGGGGGGGGGGGGGGGOGOOGGGGGR",
        "LGGGGGGGGGGGGGGGGGGGGGGGGGGGGGGGGGGGGGGGGGGGGGGGGGGGGGGGGGGGGGGR",
        "LGGGGGGGGGGGGGGGGGGGGGGGGGGGGGGGGGGGGGGGGGGGGGGGGGGGGGGGGGGGGGGR",
        "LGGGGGGGGGGGGGGGGOGGGGGGGGGGGGGGGGGOGOGOGGGGGGGGGGGGGGGGGGGGGGGR",
        "LGGGGGGGGGGGOGGGGGGGGGGGGGGGGGGGGGOOGGGGOGGGGGGGGGGGGGGGGGGGGGGR",
        "LGGGGGGGGGGGGGGGGGOGGGGGGGGGGGGGGGGGGGGGGGGGGGGGGGGGGGGGGGGGGGGR",
        "LGGGGGGGGGGGGGGGGGGGGGGGGGGGGGGGGGGGOGOGGGGGGGGGGGGGGGGGGGGGGGGR",
        "LGGGGGGGGGGGGGGGGGGGGGGGGGGGGGGGGGOGGGGOGGGGGGGGGGGGGGGGGGGGGGGR",
        "LGGGGGGGGGGGGGGGGGGGGGGGGGGGGGGGGGGGOGGGGGGGGGGGGGGGGGGGGGGGGGGR",
        "LGGGGGGGGGGGGGGGGGGGGGGGGGGGGGGGGGGOOGGGGGGGGGGGGGGGGGGGGGGGGGGR",
        "LGGGGGGGGGGGGGGGGGGGGGGGGGGGGGGGGGGGGGGGGGGGGGGGGGGGGGGGGGGGGGGR",
        "LGGGGGGGGGGGGGGGGGGGGGGGGGGGGGGGGGGGGGGGGGGGGGGGGGGGGGGGGGGGGGGR",
        "LGGGGGGGGGGGGGGGGGGGGGGGGGGGGGGGGGGGGGGGGGGGGGGGGGGGGGGGGGGGGGGR",
        "LGGGGGGGGGGGGGGGGGGGGGGGGGGGGGGGGGGGGGGGGGGGGGGGGGGGGGGGGGGGGGGR",
        "LGGGGGGGGGGGGGGGGGGGGGGGGGGGGGGGGGGGGGGGGGGGGGGGGGGGGGGGGGGGGGGR",
        "LGGGGGGGGGGGGGGGGGGGGGGGGGGGGGGGGGGGGGGGGGGGGGGGGGGGGGGGGGGGGGGR",
        "LGGGGGGGGGGGGGGGGGGGGGGGGGGGGGGGGGGGGGGGGGGGGGGGGGGGGGGGGGGGGGGR",
        "LGGGGGGGGGGGGGGGGGGGGGGGGGGGGGGGGGGGGGGGGGGGGGGGGGGGGGGGGGGGGGGR",
        "LGGOGGOGOGGGGGGGGGGGGGGGGGGGGGGGGGGGGGGGGGGGGGGGGGGGGGGGGGGGGGGR",
        "LGGOGGGGOGGGGGGGGGGGGGGGGGGGGGGGGGGGGGGGGGGGGGGGGGGGGGGGGGGGGGGR",
        "LGGOOOOOGOGGGGGGGGGGGGGGGGGGGGGGGGGGGGGGGGGGGGGGGGGGGGGGGGGGGGGR",
        "LGGGOGGGGGGGGGGGGGGGGGGGGGGGGGGGGGGGGGGGGGGGGGGGGGGGGGGGGGGGGGGR",
        "LGGGGGGGGGGGGGGGGGGGGGGGGGGGGGGGGGGGGGGGGGGGGGGGGGGGGGGGGGGGGGGR",
        "LGGGOGGOGGGGGGGGGGGGGGGGGGGGGGGGGGGGGGGGGGGGGGGGGGGGGGGGGGGGGGGR",
        "LGGGGOGGGOGGGGGGGGGGGGGGGGGGGGGGGGGGGGGGGGGGGGGGGGGGGGGGGGGGGGGR",
        "LGGGGGGGGGGGGGGGGGGGGGGGGGGGGGGGGGGGGGGGGGGGGGGGGGGGGGGGGGGGGGGR",
        "LGGGGGGGGGGGGGGGGGGGGGGGGGGGGGGGGGGGGGGGGGGGGGGGGGGGGGGGGGGGGGGR",
        "LGGGGGGGGGGGGGGGGGGGGGGGGGGGGGGGGGGGGGGGGGGGGGGGGGGGGGGGGGGGGGGR",
        "LGGGGGGGGGGGGGGGGGGGGGGGGGGGGGGGGGGGGGGGGGGGGGGGGGGGGGGGGGGGGGGR",
        "LGGGGGGGGGGGGGGGGGGGGGGGGGGGGGGGGGGGGGGGGGGGGGGGGGGGGGGGGGGGGGGR",
        "LGGGGGGGGGGGGGGGGGGGGGGGGGGGGGGGGGGGGGGGGGGGGGGGGGGGGGGGGGGGGGGR",
        "LGGGGGGGGGGGGGGGGGGGGGGGGGGGGGGGGGGGGGGGGGGGGGGGGGGGGGGGGGGGGGGR",
        "DDDDDDDDDDDDDDDDDDDDDDDDDDDDDDDDDDDDDDDDDDDDDDDDDDDDDDDDDDDDDDDD"
    ]
}