{
    "map": [
        "UUUUUUUUUUUUUUUUUUUUUUUUUUUUUUUUUUUUUUUUUUUUUUUUUUUUUUUUUUUUUUUU",
        "LMMGMMMMMMMMMMMMMMMMMMMMMMMMMMMMMMMMMMMMMMMMMGMMMMMMMMMMMMMMMMMR",
        "LMGGGGGGGGGGGGGGGGGOGOGGOGGGGGGGGGGGGGGGGGGGGGGGGGGGGGGGGGGGGGGR",
        "LGGGGGGGGGGGGGGGGGGGOOGGOGGGGGGGGGGGGGGGGGGGGGGGGGGGGGGGOGOGGGGR",
        "LGGGGGGGGGGGGGGGGGGGGGGGGGGGGGGGGGGGGGGGGGGGGGGGGGGGGGGOGGGOGGMR",
        "LGGGGGGGGGGGGGGGGGGGOOOGOGGGGGGGGGGGGGGGGGGGGGGGGGGGGGGGGGOGGGMR",
        "LGGGGGGGGGGGGGGGGGGGGOOGGGGGGGGGGGGGGGGGGGGGGGGGGGGGGOOGGGGGGGGR",
        "LGGGGGGGGGGGGGGGGGOOOGGOGGGGGGGGGGGGGGGGGGGGGGGGGGGGGGOGGGGGGGMR",
        "LMGGGGGGGGGGGGGGGGGGGGGGGGGGGGGGGGGGGGGGGGGGGGGGGGGGGGGOOOGGGGMR",
        "LMGGGGOOGGOGGGGGGGGGGGGGGGGGGGGGGGGGGGGGGGGGGGGGGGGGGOGOGOGOGGMR",
        "LGGGGGGGOGGGGGGGGGGGGGGGGGGGGGGGGGGGGGGGGGGGGGGGGGGGGGGGGGGGGGMR",
        "LGGGGGGGOGOGGGGGGGGGGGGGGGGGGGGGGGGGGGGGGGGGGGGGGGGGGGGGGGGGGGMR",
        "LGGGGGGGGGGGGGGGGGGGGGGGGGGGGGGGGGGGGGGGGGGGGGGGGGGGGGGGGGGGGGMR",
        "LGGGGOOGOGGGGGGGGGGGGGGGGGGGGGGGGGGGGGGGGGGGGGGGGGGGGGGGGGGGGGMR",
        "LGGGGGGGOGGOGGGGGGGGGGGGGGGGGGGGGGGGGGGGGGGGGGGGGGGGGGGGGGGGGGMR",
        "LGGGGOGGGGGGGGGGGGGGGGGGGGGGGGGGGGGGGGGGGGGGGGGGGGGGGGGGGGGGGGMR",
        "LGGGGGGGGGGGGGGGGGGGGGGGGGGGGGGGGGGGGGGGGGGGGGGGGGGGGGGGGGGGGGMR",
        "LMGGGGGGGGGGGGGGGGGGGGGGGGGGGGGGGGGGGGGGGGGGGGGGGGGGGGGGGGGGGGMR",
        "LGGGGGGGGGGGGGGGGGGGGGGGGGGGGGGGGGGGGGGGGGGGGGGGGGGGGGGGGGGGGGMR",
        "LGGGGGGGGGGGGGGGGGGGGGGGGGGGGGGGGGGGGGGGGGGGGGGGGGGGGGGGGGGGGGMR",
        "LGGGGGGGGGGGGGGGGGGGGGGGGGGGGGGGGGGGGGGGGGGGGGGGGGGGGGGGGGGGGGMR",
        "LMGGGGGGGGGGGGGGGGGGGGGGGGGGGGGGGGGGGGGGGGGGGGGGGGGGGGGGGGGGGGGR",
        "LGGGGGGGGGGGGGGGGGGGGGGGGGGGGGGGGGGGGGGGOGGGGGGGGGGGGGGGGGGGGGGR",
        "LGGGGGGGGGGGGGGGGGGGGGGGGGGGGGGGGGGGGGGGGGGGGGGGGGGGGGGGGGGGGGGR",
        "LGGGGGGGGGGOGGGGGGGGGGGGGGGGGGGGGGGGGGOOGGGGGGGGGGGGGGGGGGGGGGGR",
        "LGGGGOGOGGGOGGGGGGGGGGGGGGGGGGGGGGGGOGOOGGGGGGGGGGGGGGGGGGGGGGGR",
        "LGGGGOOOGGGGGGGGGGGGGGGGGGGGGGGGGGGGGGGOGOGGGGGGGGGGGGGGGGGGGGGR",
        "LGGGGOGGOGGGGGGGGGGGGGGGGGGGOOGGGGGGGGGGOGGGGGGGGGGGGGGGGGGGGGGR",
        "LGGGGOGOGGOOGGGGGGGGGGGGGGGGOGGGOGGGOGGGOGGGGGGGGGGGGGGGGGGGGGGR",
        "LGGGGOOGOGOGGGGGGGGGGGGGGGGGGOOGOGGGGGGGGGGGGGGGGGGGGGGGGGGGGGGR",
        "LGGGGGGGGOGOGGGGGGGGGGGGGGGGOOGOGGOGGGGGGGGGGGGGGGGGGGGGGGGGGGGR",
        "LGGGGGGGGGGGGGGGGGGGGGGGGGGGOGGGGGGGGGGGGGGGGGGGGGGGGGGGGGGGGGGR",
        "LGGGGGGGGGGGGGGGGGGGGGGGGGGGGGGGOOGGGGGGGGGGGGGGGGGGGGGGGGGGGGGR",
        "LGGGGGGGGGGGGGGGGGGGGGGGGGGGGGOOOGGGGGGGGGGGGGGGGGGGGGGGGGGGGGGR",
        "LGGGGGGGGGGGGGGGGGGGGGGGGGGGGGGGGGGGGGGGGGGGGGGGGGGGGGGGGGGGGGGR",
        "LGGGGGGGGGGGGGGGGGGGGGGGGGGGGGGGGGGGGGGGGGGGGGGGGGGGGGGGGGGGGGGR",
        "LGGGGGGGGGGGGGGGGGGGGGGGGGGGGGGGGGGGGGGGGGGGGGGGGGGGGGGGGGGGGGGR",
        "LGGGGGGGGGGGGGGGGGGGGGGGGGGGGGGGGGGGGGGGGGGGGGGGGGGGGGGGGGGGGGGR",
        "LGGGGGGGGGGGGGGGGGGGGGGGGGGGGGGGGGGGGGGGGGGGGGGGGGGGGGGGGGGGGGGR",
        "LGGGGGGGGGGGGGGGGGGGGGGGGGGGGGGGGGGGGGGGGGGGGGGGGGGGGGGGGGGGGGGR",
        "LGGGGGGGGGGGGGGGGGGGGGGGGGGGGGGGGGGGGGGGGGGGGGGGGGGGGGGGGGGGGGGR",
        "LGGGGGGGGGGGGGGGGGGGGGGGGGGGGGGGGGGGGGGGGGGGGGGGGGGGGGGGGGGGGGGR",
        "LGGGGGGGGGGGGGGGGGGGGGGGGGGGGGGGGGGGGGGGGGGGGGGGGGGGGGGGGGGGGGGR",
        "LGGGGGGGGGGGGGGGGGGGGGGGGGGGGGGGGGGGGGGGGGGGGGGGGGGGGGGGGGGGGGGR",
        "LGGGGGGGGGGGGGGGGGGGGGGGGGGGGGGGGGGGGGGGGGGGGGGGGGGGGGGGGGGGGGGR",
        "LGGGGGGGGGGGGGGGGGGGGGGGGGGGGGGGGGGGGGGGGGGGGGGGGGGGGGGGGGGGGGGR",
        "LGGGGGGGGGGGGGGGGGGGGGGGGGGGGGGGGGGGGGGGGGGGGGGGGGGGGGGGGGGGGGGR",
        "LGGGGGGGGGGGGGGGGGGGGGGGGGGGGGGGGGGGGGGGGGGGGGGGGGGGGGGGGGGGGGGR",
        "LGGGGGGGGGGGGGGGGGGGGGGGGGGGGGGGGGGGGGGGGGGGGGGGGGGGGGGGGGGGGGGR",
        "LGGGGGGGGGGGGGGGGGGGGGGGGGGGGGGGGGGGGGGGGGGGGGGGGGGGGGGGGGGGGGGR",
        "LGGGGGGGGGGGGGGGGGGGGGGGGGGGGGGGGGGGGGGGGGGGGGGGGGGGGGGGGGGGGGGR",
        "LGGGGGGGGGGGGGGGGGGGGGGGGGGGGGGGGGGGGGGGGGGGGGGGGGGGGGGGGGGGGGGR",
        "LGGGGGGGGGGGGGGGGGGGGGGGGGGGGGGGGGGGGGGGGGGGGGGGGGGGGGGGGGGGGGGR",
        "LGGGGGGGGGGGGGGGGGGGGGGGGGGGGGGGGGGGGGGGGGGGGGGGGGGGGGGGGGGGGGGR",
        "LGGGGGGGGGGGGGGGGGGGGGGGGGGGGGGGGGGGGGGGGGGGGGGGGGGGGGGGGGGGGGGR",
        "LGGGGGGGGGGGGGGGGGGGGGGGGGGGGGGGGGGGGGGGGGGGGGGGGGGGGGGGGGGGGGGR",
        "LGGGGGGGGGGGGGGGGGGGGGGGGGGGGGGGGGGGGGGGGGGGGGGGGGGGGGGGGGGGGGGR",
        "LGGGGGGGGGGGGGGGGGGGGGGGGGGGGGGGGGGGGGGGGGGGGGGGGGGGGGGGGGGGGGGR",
        "LGGGGGGGGGGGGGGGGGGGGGGGGGGGGGGGGGGGGGGGGGGGGGGGGGGGGGGGGGGGGGGR",
        "LGGGGGGGGGGGGGGGGGGGGGGGGGGGGGGGGGGGGGGGGGGGGGGGGGGGGGGGGGGGGGGR",
        "LGGGGGGGGGGGGGGGGGGGGGGGGGGGGGGGGGGGGGGGGGGGGGGGGGGGGGGGGGGGGGGR",
        "LGGGGGGGGGGGGGGGGGGGGGGGGGGGGGGGGGGGGGGGGGGGGGGGGGGGGGGGGGGGGGGR",
        "LGGGGGGGGGGGGGGGGGGGGGGGGGGGGGGGGGGGGGGGGGGGGGGGGGGGGGGGGGGGGGGR",
        "DDDDDDDDDDDDDDDDDDDDDDDDDDDDDDDDDDDDDDDDDDDDDDDDDDDDDDDDDDDDDDDD"
    ]
}