{
    "map": [
        "UUUUUUUUUUUUUUUUUUUUUUUUUUUUUUUUUUUUUUUUUUUUUUUUUUUUUUUUUUUUUUUU",
        "LMMGMMMGGGGGGGGGGGGGGGGGGGGGMMMMMMMGMMMMMMMMMMMMMMMMMMMMGMMMMMGR",
        "LGGGGGGGGGGGGGGGGGGGGGGGGGGGGGGGGGGGGGGGGGGGGGGGGGGGGGGGGGGGGGGR",
        "LGGGGGGGGGGGGGGGGGGGGGGGGGGGGGGGGGOGOGGGGGGGGGGGGGGGGGGGGGGGGGGR",
        "LMGGGGGGGGGGGGGGGGGGGGGGGGGGGGGGOGGGGGGGGGGGGGGGGGGGGGGGGGGGGGMR",
        "LMGGGGGGGGGGGGGGGGGGGGGGGGGGGGOGOGGGGGGGGGGGGGGGGGGGGGGGGGGGGGMR",
        "LMGGGGGGGGGGGGGGGGGGGGGGGGGGGGOGGGGGGGGGGGGGGGGGGGGGGGGGGGGGGGGR",
        "LGGGGGGGGGGGGGGGGGGGGGGGGGGGGGOGGGGOGGGGGGGGGGGGGGGGGGGGGGGGGGMR",
        "LMGGGGGGGGGGGGGGGGGGGGGGGGGGGGGGOOGOGGGGGGGGGGGGGGGGGGGGGGGGGGMR",
        "LMGGGGGGGGGGGGGGGGGGGGGGGGGGGGOGOOGGGGGGGGGGGGGGGGGGGGGGGGGGGGMR",
        "LMGGGGGGGGGGGGGGGGGGGGGGGGGGGGGGGGGGGGGGGGGGGGGGGGGGGGGGGGGGGGMR",
        "LMGGGGGGGGGGGGGGGGGGGGGGGGGGGGGGGGGGGGGGGGGGGGGGGGGGGGGGGGGGGGMR",
        "LMGGGGGGGGGGGGGGGGGGGGGGGGGGGGGGGGGGGGGGGGGGGGGGGGGGGGGGGGGGGGMR",
        "LMGGGGGGGGGGGGGGGGGGGGGGGGGGGGGGGGGGGGGGGGGGGGGGGGGGGGGGGGGGGGMR",
        "LMGGGGGGGGGGGGGGGGGGGGGGGGGGGGGGGGGGGGGGGGGGGGGGGGGGGGGGGGGGGGMR",
        "LMGGGGGGGGGGGGGGGGGGGGGGGGGGGGGGGGGGGGGGGGGGGGGGGGGGGGGGGGGGGGMR",
        "LMGGGGGGGGGGGGGGGGGGGGGGGGGGGGGGGGGGGGGGGGGGGGGGGGGGGGGGGGGGGGMR",
        "LMGGGGGGGGGGGGGGGGGGGGGGGGGGGGGGGGGGGGGGGGGGGGGGGGGGGGGGGGGGGGMR",
        "LMGGGGGGGGGGGGGGGGGGGGGGGGGGGGGGGGGGGGGGGGGGGGGGGGGGGGGGGGGGGGMR",
        "LMGGGGGGGGGGGGGGGGGGGGGGGGGGGGGGGGGGGGGGGGGGGGGGGGGGGGGGGGGGGGMR",
        "LMGGGGGGGGGGGGGGGGGGGGGGGGGGGGGGGGGGGGGGGGGGGGGGGGGGGGGGGGGGGGMR",
        "LMGGGGGGGGGGGGGGGGGGGGGGGGGGGGOGOGOOGGGGGGGGGGGGGGGGGGGGGGGGGGGR",
        "LGGGGGGGGGGGGGGGGGGGGGGGGGGGGGOGGOOOGGGGGGGGGGGGGGGGGGGGGGGGGGGR",
        "LGGGGGGGGGGGGGGGGGGGGGGGGGGGGGOOGGGOGGGGGGGGGGGGGGGGGGGGGGGGGGGR",
        "LGGGGGGGGGGGGGGGGGGGGGGGGGGGGOGOGOGOGGGGGGGGGGGGGGGGGGGGGGGGGGGR",
        "LGGGGGGGGGGGGGGGGGGGGGGGGGGGGGGOOGGGGGGGGGGGGGGGGGGGGGGGGGGGGGGR",
        "LGGGGGGGGGGGGGGGGGGGGGGGGGGGGGGGOGOOGGGGGGGGGGGGGGGGGGGGGGGGGGGR",
        "LGGGGGGGGGGGGGGGGGGGGGGGGGGGGGGOOOGOGGGGGGGGGGGGGGGGGGGGGGGGGGGR",
        "LGGGGGGGGGGGGGGGGGGGGGGGGGGGGGGGGGGGGGGGGGGGGGGGGGGGGGGGGGGGGGGR",
        "LGGGGGGGGGGGGGGGGGGGGGGGGGGGGGGGGGGGGGGGGGGGGGGGGGGGGGGGGGGGGGGR",
        "LGGGGGGGGGGGGGGGGGGGGGGGGGGGGGGGGGGGGGGGGGGGGGGGGGGGGGGGGGGGGGGR",
        "LGGGGGGGGGGGGGGGGGGGGGGGGGGGGGGGGGGGGGGGGGGGGGGGGGGGGGGGGGGGGGGR",
        "LGGGGGGGGGGGGGGGGGGGGGGGGGGGGGGGGGGGGGGGGGGGGGGGGGGGGGGGGGGGGGGR",
        "LGGGGGGGGGGGGGGGGGGGGGGGGGGGGGGGGGGGGGGGGGGGGGGGGGGGGGGGGGGGGGGR",
        "LGOOGOGGGGGGGGGGGGGGGGGGGGGGGGGGGGGGGGGGGGGGGGGGGGGGGGGGGGGGGGGR",
        "LGGGGGGGGGGGGGGGGGGGGGGGGGGGGGGGGGGGGGGGGGGGGGGGGGGGGGGGGGGGGGGR",
        "LGGGGGGGGGGGGGGGGGGGGGGGGGGGGGGGGGGGGGGGGGGGGGGGGGGGGGGGGGGGGGGR",
        "LGGGGGGGGGGGGGGGGGGGGGGGGGGGGGGGGGGGGGGGGGGGGGGGGGGGGGGGGGGGGGGR",
        "LGGGGGGGGGGGGGGGGGGGGGGGGGGGGGGGGGGGGGGGGGGGGGGGGGGGGGGGGGGGGGGR",
        "LOGOGGGGGGGGGGGGGGGGGGGGGGGGGGGGGGGGGGGGGGGGGGGGGGGGGGGGGGGGGGGR",
        "LGGOOGGGGGGGGGGGGGGGGGGGGGGGGGGGGGGGGGGGGGGGGGGGGGGGGGGGGGGGGGGR",
        "LGGGGGGGGGGGGGGGGGGGGGGGGGGGGGGGGGGGGGGGGGGGGGGGGGGGGGGGGGGGGGGR",
        "LGGGGGGGGGGGGGGGGGGGGGGGGGGGGGGGGGGGGGGGGGGGGGGGGGGGGGGGGGGGGGGR",
        "LOOGGGOGGGGGGGGGGGGGGGGGGGGGGGGGGGGGGGGGGGGGGGGGGGGGGGGGGGGGGGGR",
        "LGGGGGGGGGGGGGGGGGGGGGGGGGGGGGGGGGGGGGGGGGGGGGGGGGGGGGGGGGGGGGGR",
        "LGOOOGGGGGGGGGGGGGGGGGGGGGGGGGGGGGGGGGGGGGGGGGGGGGGGGGGGGGGGGGGR",
        "LGOOOOGGGGGGGGGGGGGGGGGGGGGGGGGGGGGGGGGGGGGGGGGGGGGGGGGGGGGGGGGR",
        "LGGOGGGOGGGGGGGGGGGGGGGGGGGGGGGGGGGGGGGGGGGGGGGGGGGGGGGGGGGGGGGR",
        "LGGGGGGGGGGOGGOGGGGGGGGGGGGGGGGGGGGGGGGGGGGGGGGGGGGGGGGGGGGGGGGR",
        "LGGGGGGGOGGGGOGGGGGGGGGGGGGGGGGGGGGGGGGGGGGGGGGGGGGGGGGGGGGGGGGR",
        "LGGGGGGGGGGGOGGGGGGGGGGGGGGGGGGGGGGGGGGGGGGGGGGGGGGGGGGGGGGGGGGR",
        "LGGGGGGGOGOOGOOGGGGGGGGGGGGGGGGGGGGGGGGGGGGGGGGGGGGGGGGGGGGGGGGR",
        "LGGGGGGGGGOGGGGGGGGGGGGGGGGGGGGGGGGGGGGGGGGGGGGGGGGGGGGGGGGGGGGR",
        "LGGGGGGGGGGOOGOGGGGGGGGGGGGGGGGGGGGGGGGGGGGGGGGGGGGGGGGGGGGGGGGR",
        "LGGGGGGGOGGOOOOGGGGGGGGGGGGGGGGGGGGGGGGGGGGGGGGGGGGGGGGGGGGGGGGR",
        "LGGGGGGGGGGGGOOGGOGGGGGGGGGGGGGGGGGGGGGGGGGGGGGGGGGGGGGGGGGGGGGR",
        "LGGGGGGGGGGGOGOOGOGGGGGGGGGGGGGGGGGGGGGGGGGGGGGGGGGGGGGGGGGGGGGR",
        "LGGGGGGGGGGGOOGGGOGGGGGGGGGGGGGGGGGGGGGGGGGGGGGGGGGGGGGGGGGGGGGR",
        "LGGGGGGGGGGGGOGOOGOGGGGGGGGGGGGGGGGGGGGGGGGGGGGGGGGGGGGGGGGGGGGR",
        "LGGGGGGGGGGGGGGGGGGGGGGGGGGGGGGGGGGGGGGGGGGGGGGGGGGGGGGGGGGGGGGR",
        "LGGGGGGGGGGGGGGGOGGGGGGGGGGGGGGGGGGGGGGGGGGGGGGGGGGGGGGGGGGGGGGR",
        "LGGGGGGGGGGGGOGGGGOGGGGGGGGGGGGGGGGGGGGGGGGGGGGGGGGGGGGGGGGGGGGR",
        "LGGGGGGGGGGGGGGGGGGGGGGGGGGGGGGGGGGGGGGGGGGGGGGGGGGGGGGGGGGGGGGR",
        "DDDDDDDDDDDDDDDDDDDDDDDDDDDDDDDDDDDDDDDDDDDDDDDDDDDDDDDDDDDDDDDD"
    ]
}